################################################
#..................................#.#.#...#...#
#################################......#.###.#.#
#......................................#.#.#.#.#
###############################.#............#.#
#...............................##############.#
#.#########################.#####....b.........#
#.#.......#.....................#.##############
#......####.#.#.###############.#..............#
########..#.#.###.........#.#.#.##############.#
#z.c........#......#..#........a...............#
################################################
